*****   *    *  *    *  ******  ******  ******  *    *        ******  ******        *****   ******  ******  *   *   *    *  ******  ******  ******
*    *  *    *  **   *  *       *       *    *  **   *        *    *  *             *    *  *    *  *    *  *  *    **   *  *       *       *     
*    *  *    *  * *  *  *       *       *    *  * *  *        *    *  *             *    *  *    *  *    *  * *     * *  *  *       *       *     
*    *  *    *  *  * *  *       *       *    *  *  * *        *    *  *             *    *  *    *  *    *  **      *  * *  *       *       *     
*    *  *    *  *   **  *  ***  ******  *    *  *   **        *    *  ******        *    *  ******  ******  *       *   **  ******  ******  ******
*    *  *    *  *    *  *    *  *       *    *  *    *        *    *  *             *    *  *    *  **      **      *    *  *            *       *
*    *  *    *  *    *  *    *  *       *    *  *    *        *    *  *             *    *  *    *  * *     * *     *    *  *            *       *
*    *  *    *  *    *  *    *  *       *    *  *    *        *    *  *             *    *  *    *  *  *    *  *    *    *  *            *       *
*****   ******  *    *  ******  ******  ******  *    *        ******  *             *****   *    *  *   *   *   *   *    *  ******  ******  ******